################################################################################
#..............................................................................#
#...........###..##...................................^^.......................#
#..........######....................................^^........................#
#.........####....,,,,,;;;;;;.......................^^^...^^^^^^...............#
#........##......,,;;;;;;;;;;;.......................^^^^^^^^..................#
#.......##......;;,,,,,,,,######.......................^^^^....................#
#.......###....;;;,,;;;;;;;;;####........................^^^......#............#
#........###...,,;;;;;;®;;;;;###..........................^^^.....#####....#...#
#.........####,,,,,,,,,,;;;;;######................................#####.#######
#............;;,,;;;;;;;;;;#########............##########.............####;;;;#
#.............;;;,,,,,########....#######.......#...::~~~~~#..........###;;;;..#
#...............;;;;;;;;...........########....#..#####~#~~#...........#;;~~~=~#
#..................:::........##......##########..##...#.#~#..........#;;~~~==~#
#...###...........:~~~:.......##.........########..###....#............,,~~==~~#
#..#####.........:~~~~~:..............##,..........###................,,,,=~~~~#
#.##.###.........:~~~~:..............##,,,.............#...............,,,~~;;;#
#.#..##...........:~~:....###.......##,,,,,,,,#.....................##..#.;;;;.#
#.##.####..........::......##......##,,,††,,,#####..................###.#####..#
#.##..####........###.......#....######,††,####.######................####.....#
#........##.......########..##...##..#######......###..................#.......#
#:::::..####.......############.##......#####......#.#.........................#
#~~:::::##..........###.......#..#.......#####.........#.......................#
#~~~~~~::######...####..#....######....................###.........##...##.....#
#~~===~~:##...#..####..####...##........:::.............#####.......##.##......#
#~~~~=~~::..###....#####.###..#.......,,;;,.............###..........###.......#
#~~~====::..##....##......#............,,;;,,...............####......##.......#
#~==~~~::....#####.....########.........,,;,,,...............#.#.......##......#
#©~~~~::..................................;;,..................................#
################################################################################