################################################################################
################################################################################
################################################################################
################################################################################
################################################################################
################################################################################
######################################...#######################################
####################################.......#####################################
####################################.......#####################################
###################################.........####################################
##################################...........###################################
##################################...........###################################
#################################.............##################################
################################...............#################################
################################...............#################################
################################...............#################################
################################...............#################################
################################...............#################################
#################################.............##################################
##################################...........###################################
##################################...........###################################
###################################.........####################################
####################################.......#####################################
####################################.......#####################################
######################################...#######################################
################################################################################
################################################################################
################################################################################
################################################################################
################################################################################