################################################################################
#§.............................................................................#
#^^^^^^^^^^^^^^^^^^^^^^^^^^^^^^^^^^^^^^^^^^^^^^^^^^^^^^.^^^^^^^^^^^^^^^^^^^^^^^#
#....$$$$.............^...........^...................^.^^^....................#
#....$$$$.............^.^.........^...................^.^^^..^^^^^^^^^^^^^^.^^.#
#....$$$$.............^.^.........^...................^.^^^..^^^^^^^^^^^^^^^^..#
#.^^^^^^^^^^^^^^^^^^^^^.^....... .^...................^.^^^...^^^^^^^^^^^^^^^..#
#.....................^.^.........^...................^.^^^.................^..#
#.....................^.^.........^...................^.^^^...^^^^^^^^^^^^^^^^.#
#^^^^^^^^^^^^^^^^^^^..^.^.........^...................^.^^^.....^^^^^^^^^.^....#
#.....................^.^.........^...................^.^^^..^^^^^^^^^^^^^^^^..#
#..^^^^^^^^^^^^^^^^^^^^.^....^^^^^^...................^.^^^..^^^^^^^^^^^^^^^^..#
#.....................^.^....^^^^^^...................^.^^^..^^^^^^^^^^^^^^^^..#
#.....................^.^.....T^^^^~~~~~~~~~..~~~~~~~~^.^^^................^...#
#^^^^^^^^^^^^^^^^^^^..^.^....^^^^^^~~~~~~~~~..~~~~~~~~^.^^^..^^^^^^^^^^^^^^^^..#
#.....................^.^....^^^^^^~~~~~~~~~..~~~~~~~^.^^^..^^^^^^^^^^^^^^^^...#
#..^^^^^^^^^^^^^^^^^^^^.^.........^...................^.^^^..^^^^^^^^^^^^^^^^..#
#.....................^.^.........^...................^.^^^..^^^^^^^^^^^^^^^^..#
#.....................^.^.........^...................^.^^^..^^^^^^^^^^^^^^^^..#
#^^^^^^^^^^^^^^^^^^^..^.^.........^...................^.^^^..^^^^^^^^^^^^^^^^..#
#.....................^.^.........^...................^.^^^..^^^^^^^^^^^^^^^^..#
#..^^^^^^^^^^^^^^^^^^^^.^.........^...................^.^^^..^^^^^^^^^^^^^^^^..#
#.....................^.^.........^...................^.^^^..^^^^^^^^^^^^^^^^..#
#.....................^.^.........^...................^.^^^..^^^^^^^^^^^^^^^^..#
#^^^^^^^^^^^^^^^^^^^..^.^.........^...................^.^^^..^^^^^^^^^^^^^^^^..#
#.....................^.^.........^...................^.^^^..^^^^^^^^^^^^^^^^..#
#..^^^^^^^^^^^^^^^^^^^^.^.........^...................^.^^^..^^^^^^^^^^^^^^^^..#
#.....................^.^^^^^^^^^^....................^.^^^..^^^^^^^^^^^^^^^^..#
#............................................................^....^^^^^^^^^^^^^#
################################################################################