################################################################################
################################################################################
################################################################################
################################################################################
################################################################################
################################################################################
#################...........................................####################
#################...........................................####################
#################...........................................####################
#################...........................................####################
#################...........................................####################
#################...........................................####################
#################....................PPP....................####################
#################....................PPP....................####################
#################....................PPP....................####################
#################...........................................####################
#################...........................................####################
#################...........................................####################
#################...........................................####################
#################...........................................####################
#################...........................................####################
#################...........................................####################
#################...........................................####################
################################################################################
################################################################################
################################################################################
################################################################################
################################################################################
################################################################################
################################################################################