################################################################################
#..............................................................................#
#..............................................................................#
#..............................................................................#
#.............................................$$$$$............................#
#..............T..............................$$$$$............................#
#.............................................$$$$$............................#
#..............................................................................#
#..........................§...................................................#
#..............................................................................#
#########################################################################......#
#..............................................................................#
#..........................~~~~................................................#
#..........................~~~~................................................#
#..........................~~~~................................................#
#..............................................................................#
#..............................................................................#
#..............................................................................#
#..............................................................................#
#.........................................^^^^^^...............................#
#..............................................................................#
#..............................................................................#
#..............................................................................#
#..............................................................................#
#..............................................................................#
#..............................................................................#
#..............................................................................#
#..............................................................................#
#..............................................................................#
################################################################################