################################################################################
#,,,,,,,,,,;;;;;;;,,,,;,,,,,..,,,,,..^®...;.....;...;......^....^^....^^.......#
#.;;;;;,,,,,,,,,,,,,,,;,,,,,,;;;;;;..^...^.........;...;.....^^.^^.^^.^^..^^...#
#....;;;;;;;................,,,......^^..^^^^;;;;;~~~~.......^^,,,,^^,,,,,^^...#
#......,,,,,,,..~~~~~....,,;;;;,,,,,;;;;^^^^^..,,.~~~~~~...;;;;;;;;;;;;;;;;....#
#..,,,,;;;;;,,,~~~~~~~..,,,,,,,,,,,......;;;........~~~~~....,,,,,,,,,.........#
#....~~..........~~~~....,,,,,,,,........;;;........~~......,,,,,,,,,..........#
#....~~........~~~...,,,;,,;,,........~~.........;;;;;;;;;;;;;;;;;;;;..........#
#......................,,;,,,,;....~~~~.......^^.....,,;,,,,,,,;;;;;;;;;;;;;;;.#
#;;;;;;;;,;;;;;.^^...~~~~~..,,,,,....~~~~~....^^^^.....;.......;......~~~~..;..#
#;;;;;;;;,;;;;;.....~~;~~......;;;.....~~.......^^^.......,,,,;,,,..~~~.....;..#
#............;.......~~~~~~...,;,,,,,,,,,,,,......~~~~~~.....;,,,,,.;~~~....;..#
#..;;;;....~~~~~......,,,,,,,,,,,,,,..........~~~~~....~~~~~~.......;.~~~...;..#
#.,,,,,..~~~;.;~~~~..........;;...........~~~~~...,;;,,...~~~~~~~...........;..#
#.;;;;;~~~.,,;,,..~~~~...;;;;;;;;;....~~~~~.....,,,,;,,,,;;,,;..~~~~~..........#
#....~~~...,,;,,....~~~~..........~~~~~~....,,,,,,,,;,,,,.;.;,,,,,..~~~~.......#
#...===.,,,,,;,,,,,,,..~~~~..~~~~~~~....;........~~~~...,,;,;,,,,,....~~~=~....#
#.~~~,,,;;;;;;;;;;;;;;....~~~~~......,,,,.........~~~..,,,;,;,,,,,....###=~~~..#
#~~~,,;;......,,,,,;,,..^^^^....,,,,,,,,,,,,....~~~~..,,,,;,;,,,,,....###...~~~#
#,,;,;;........,,,,;,,.....................................;..........###;;;,,.#
#.,,,;......~~~~~.;;;;;;;;;;;;;;;;;~~~~^^^^^^^^^^^^^^^^^^^^^..........###.,,;;;#
#;;;;;.......~~~~~........~~~~.....~~~~...,,,,,....,,,,.;..~~~~~......###..,,..#
#.......;....~~~~........~~~~~..^...~~....;,,,,^^,,,,,,,;...~~~~~.....###,;;;..#
#....;...................~~~~...^.......^,;,,,,^^,,,,,,,;....~~~~.....###.,,,,,#
#..;,;,,......,,,,,,,,,,,,,,,,,,^,,,,,,,,.;.............;.............###......#
#..;,,;,..~~~~^^^^^^^^^^^^^^^^^^^^^^^;^^^^^^...~~~~~~...;,,,,,,,,.....###.,,,,.#
#..,,,,....~.......,,;;,,;;,,;,,,;,.,,,,,,,^..~~~~~~~..,;,,,,,,,,.....###.;....#
#..;,,;,,.....,,,,,,,;,;,,;,;,;,;.;,,......^^....~~~~...;,,,,,,,,,,,..###,;,;,,#
#..;.........,,,,,,,,,;,,..;,,,;...;...©...^^^..........,,,,,,,,,,,,.#...;;;;..#
################################################################################