################################################################################
#....####.††........................###~~:::.......##...............####.....###
#...######††.####.............#......###~~::::......##...............##©.###...#
#....##...########.........#####......##:~~~~:::.....#....##########..########.#
#....###.###..##.........##########....##::~~~~::......####,,,...########......#
#......###...####.....###################.:::~~~::::......,,,,,.....#####.######
#,.........#######........#############.....:::~~~:::......,,,,###.....##....###
#,,.....###########......................###..:::~~~:.........##........####.###
#,,..................#...............########..::~~~:.......###.........~~##:###
#...............########.........#############::~~~~:.....###........:::~~:::::#
#.........#################.........#########.::===:::.####.........:::~~~:::::#
#.....##################...............##....::~~~~::####............::~~~~::::#
######################........................::~~::###...............:::::::::#
####################............#########.......:~~##..........,,,,,,,,,,,,::::#
#######....:::::::...........##########........:~~##.........,,,^^^^^^,,,,,,,::#
####......:::::~~::............######.......:~~~~##....::,,,,,^^^^^^^^^,,,,,,,,#
#.......::::~~~~~~:::...........####.......:~~~###.....:,,,,,,^,^,,,~,,,,,,,,,:#
#,......::~~~~~~~~~~::............##....::~~~###.......::,,,,,^,^,,~~~~,,,,,,::#
#,,.....:::~~~~~~~~::.........#####....::~~^##...........::,,,,,,,,,~~,,,,,,,,:#
#,,,......::::~~~:::......##########...:~~^^^##..........:::::^^,,,,,,,,,,,,:::#
#,,......::::::::::::..........###..:::~~:....##........:::::::^^::::::::::::::#
#......#####...................####:::~~:......................^^^::::::.......#
#...#########.....###......###....::~~~:................^^^^^^^^^^^...........##
#......##########........####....::~~~:::...........^^^^^^^^^^^^^^........######
#...........#########......#...:::~~~::...........^^^^¬¬¬¬¬^^^^^.........#####.#
#..............................:::~~::............,,,..^^^..............######.#
#........^^.....###...........::,,===............,,,,,^^^............#..#####..#
#######.^^^^...#..............:,,,,~~::...........,,,..^^...........###.....#.##
###®..........##..............,,,,,,,~~::............................######...##
################################################################################